NO ./textures/01.xpm
EA ./textures/01.xpm
WE ./textures/01.xpm
SO ./textures/01.xpm
F 200,0,150
C 11,222,123




1111111111
10000N0001
1000000001
100$010001
1000000001
11P1011111
1000000001
1110000111
1000000001
1000000001
1111111111

