NO ./textures/01.xpm
EA ./textures/01.xpm
WE ./textures/01.xpm
SO ./textures/01.xpm
F 200,0,150
C 11,222,123




111111111
100001111
100000001
101101111
101001111
100001111
101101111
101101111
100000001
1000E1111
111111111