NO ./textures/01.xpm
EA ./textures/01.xpm
WE ./textures/01.xpm
SO ./textures/01.xpm
F 200,0,150
C 11,222,123




1111111111
1100011101
1000000001
1000011101
1000000001
1011000101
1000E01101
1111111111